#####
#@$.#
#####
;
 ########
##      #
#   .   #
#   $   #
# .$@$. #
####$   #
   #.   #
   #   ##
   #####
;
######  ### 
#..  # ##@##
#..  ###   #
#..     $$ #
#..  # # $ #
#..### # $ #
#### $ #$  #
   #  $# $ #
   # $  $  #
   #  ##   #
   #########
;
   ###
  ## # ####
 ##  ###  #
## $      #
#   @$ #  #
### $###  #
  #  #..  #
 ## ##.# ##
 #      ##
 #     ##
 #######
;
    #####
   ## . #
  ## $. #
 ## $   #
## $@ ###
# $  ##
#.. ##
#   #
#####
;
           #####
          ##   #
          #    #
    ####  # $ ##
    #  ####$ $#
    #     $ $ #
   ## ## $ $ $#
   #  .#  $ $ #
   #  .#      #
##### #########
#.... @  #
#....    #
##  ######
 ####
;
  ###########
 ##     #  @#
### $ $$#   #
# ##$    $$ #
#  #  $ #   #
###### ######
#.. ..$ #*##
# ..    ###
#  ..#####
#########
;
  ###########
 ##    #    ##
### $ $#$ $ ###
# #$ $ # $ $# #
# $  ..#..  $ #
#  $...#...$  #
# $ .. * .. $ #
###### @ ######
# $ ..   .. $ #
#  $...#...$  #
# $  ..#..  $ #
# #$ $ # $ $# #
### $ $#$ $ ###
 ##    #    ##
  ###########
;
  ###########
###.  .$.  .###
 ## $  $  $ ##
  ## ..$.. ##
   ##$#$#$##
    #.$ $.#
    #  @  #
    ### ###
   ## $ $ ##
   #.  $  .#
   ### . ###
     #####
;
           ######
    ####  ##    #
  ###  #  #  ## ###
###    #### #   $ #
#  $ @ ...*..  $  #
# $ $  ## ###   ###
### ###   # #####
 #      ###
 #   ####
 #####
;
    #######
    #     ##
##### ###  ##
#       #  ##
#@$***. ##$ #
#  #    ## .#
##  ##  # $ #
 ##  ####.$.#
  ##        #
   ######  ##
        ####
;
#########
#. .    #
#.$. .  #
## ###@ #
 #  $  ##
 # $$ ##
 #  $ #
 #  ###
 ####
;
     #######
######     ######
#  . ..$#$.. .  #
#  $ $  .  $ $  #
###$####@####$###
#  $ $  .  $ $  #
#  . ..$#$.. .  #
######     ######
     #######
;
 #######
 #  #  #
 #$ @ $#
 # .#. #
##$.#.$##
# $ . $ #
#   #   #
#########
;
  #####
###   ##
#  $#  #
#  .@.$##
##.# #  #
 # $    #
 ##  ####
  ####